{
    "tiles": [
        [" ", " ", " ", " ", " ", " ", " ", " ", " ", " ", " ", " ", " ", " ", " ", " "],
        [" ", " ", " ", " ", " ", "#", "#", "#", "#", "#", "#", " ", " ", " ", " ", " "],
        [" ", " ", " ", " ", " ", " ", " ", "-", "-", " ", " ", " ", " ", " ", " ", " "],
        ["~", "~", "~", "~", "~", "~", "~", "-", "-", "~", "~", "~", "~", "~", "~", "~"],
        ["~", "~", "~", "~", "~", "~", "~", "-", "-", "~", "~", "~", "~", "~", "~", "~"],
        ["~", "~", "~", "~", "~", "~", "~", "-", "-", "~", "~", "~", "~", "~", "~", "~"],
        [" ", " ", " ", " ", " ", " ", " ", "-", "-", " ", " ", " ", " ", " ", " ", " "],
        [" ", " ", " ", " ", " ", " ", " ", "-", "-", " ", " ", " ", " ", " ", " ", " "],
        [" ", " ", " ", " ", " ", " ", " ", "-", "-", " ", " ", " ", " ", " ", " ", " "],
        [ 1 , "-", "-", "-", "-", "-", "-", "-", "-", "-", "-", "-", "-", "-", "-",  2 ],
        [ 1 , "-", "-", "-", "-", "-", "-", "-", "-", "-", "-", "-", "-", "-", "-",  2 ],
        [" ", " ", " ", " ", " ", " ", " ", " ", " ", " ", " ", " ", " ", " ", " ", " "]
    ],
    "links": {
        "1": null,
        "2": 1
    }
}