{
    "tiles": [
        [" ", " ", " ", " ", " ", " ", " ", " ", " ", " ", " ", " ", " ", " ", " ", " "],
        [" ", " ", " ", " ", " ", "#", "#", "#", "#", "#", "#", " ", " ", " ", " ", " "],
        [" ", " ", " ", " ", " ", " ", " ", "-", "-", " ", " ", " ", " ", " ", " ", " "],
        ["~", "~", "~", "~", "~", "~", "~", "-", "-", "~", "~", "~", "~", "~", "~", "~"],
        ["~", "~", "~", "~", "~", "~", "~", "-", "-", "~", "~", "~", "~", "~", "~", "~"],
        ["~", "~", "~", "~", "~", "~", "~", "-", "-", "~", "~", "~", "~", "~", "~", "~"],
        [" ", " ", " ", " ", " ", " ", " ", "-", "-", " ", " ", " ", " ", " ", " ", " "],
        [" ", " ", " ", " ", " ", " ", " ", "-", "-", " ", " ", " ", " ", " ", " ", " "],
        [" ", " ", " ", " ", " ", " ", " ", "-", "-", " ", " ", " ", " ", " ", " ", " "],
        [ 1 , "-", "-", "-", "-", "-", "-", "-", "-", "-", "-", "-", "-", "-", "-",  2 ],
        [ 1 , "-", "-", "-", "-", "-", "-", "-", "-", "-", "-", "-", "-", "-", "-",  2 ],
        [" ", " ", " ", " ", " ", " ", " ", " ", " ", " ", " ", " ", " ", " ", " ", " "]
    ],
    "links": {
        "1": null,
        "2": 1
    },
    "enemies": [
        [" ", " ", " ", " ", " ", " ", " ", " ", " ", " ", " ", " ", " ", " ", " ", " "],
        [" ", " ", " ", " ", " ", " ", " ", " ", " ", " ", " ", " ", " ", " ", " ", " "],
        [" ", " ", " ", " ", " ", " ", " ",  1 , " ", " ", " ", " ", " ", " ", " ", " "],
        [" ", " ", " ", " ", " ", " ", " ", " ", " ", " ", " ", " ", " ", " ", " ", " "],
        [" ", " ", " ", " ", " ", " ", " ", " ", " ", " ", " ", " ", " ", " ", " ", " "],
        [" ", " ", " ", " ", " ", " ", " ", " ", " ", " ", " ", " ", " ", " ", " ", " "],
        [" ", " ", " ", " ", " ", " ", " ", " ", " ", " ", " ", " ", " ", " ", " ", " "],
        [" ", " ", " ", " ", " ", " ", " ", " ", " ", " ", " ", " ", " ", " ", " ", " "],
        [" ", " ", " ", " ", " ",  2 , " ", " ", " ", " ", " ", " ", " ", " ", " ", " "],
        [" ", " ", " ", " ", " ", " ", " ", " ", " ", " ", " ", " ", " ", " ", " ", " "],
        [" ", " ", " ", " ", " ", " ", " ", " ", " ", " ", " ", " ", " ", " ", " ", " "],
        [" ", " ", " ", " ", " ", " ", " ", " ", " ", " ", " ", " ", " ", " ", " ", " "]
    ],
    "enemies_data": {
        "1": {
            "movement": "(1, 5)",
            "speed": 1
        },
        "2": {
            "movement": "(5, 0)",
            "speed": 1
        }
    }
}